111111111111111111111111
1kmcccx00000M00000000M01
1mcccc100111110001111101
1111111001A000000000A101
1O0000000100000000000101
100000000000001110000001
1A000M000000001110000001
111111000000001110000M01
1000O1000100000000000101
1P00010001H000000000H101
100001000111110001111101
100001000000000000000001
11y1t11111111111111111Y1
11c1gg1HH00010001OO10101
11c11g10M0001010100001M1
11c1ng100000X01010010101
11y111111111111010010001
1000000000M0X00010010101
1A00000000GH1O10000101A1
111111111111111111111111
E
